0;0;9;19
...*     X .*    *  
 *..*   *X .........
   .     =   *.*  *.
  *.   * XXXX .    .
XXX=XX   X *XX=XXX*.
  *.*X   =  X*.  X  
   . X * X  X . *X* 
*  .*XX=XX *X . XXXX
 ....  .... X . X   
 . *....* . X*. = *  .